###############
# P                
# O                     
# X ###########
#   #  
#####


#####
#   #
#   #
#   #
#   #
#####